-----------I---===---I---------- 
|           t       t           |
|    e     |         |    e     |
|          |         |          |
|          |         |          |
|          |         |          |
|          |         |          |
|          |         |          |
L---===----|         L----===---|
|                               |
|    e                    e     |
|                               |
|           t       t           |
L--------------   --------------|
