-----------I---===---I---------- 
|             g   g             |
|    t     |         |    t     |
|          |         |          |
|          |         |          |
|          |         |          |
|          |         |          |
|          |         |          |
L---===----|         L----===---|
|  g   g                 g   g  |
|    t                    t     |
|                               |
|             g   g             |
L--------------   --------------|
