-----w-----I---===---I----w----- 
|           t       t           |
|    e     |         |    e     |
|          |         |          |
|          |         |          |
|          |         |          |
|          |         |          |
|          |         |          |
L---===----|         L----===---|
|                               |
|    e                    e     |
|                               |
|           t       t           |
L----w--------- - --------w-----|
