---==--- 
|       |
|       |
|       |
|       |
|       |
|       |
|       |
|       |
+--  ---|
