-----------I---===---I---------- 
|                               |
|    x     |         |    x     |
|          |         |          |
|          |         |          |
|          |         |          |
|          |         |          |
|          |         |          |
L---===----|         L----===---|
|                               |
|    x                    x     |
|                               |
|                               |
L--------------   --------------|
