---==------ 
|          |
|          |
|          |
|          |
|          |
|          |
|          |
|          |
+--  ------|
