---==--- 
|       |
|       |
|       |
|       |
|       |
|       |
|       |
|       |
+--==---|
