-----w-----G---===---G----w----- 
|                               |
|    e     | t     t |    e     |
|          |         |          |
|          |         |          |
|          |         |          |
|          |         |          |
|          |         |          |
L---===----|         L----===---|
|                               |
|    e                    e     |
|                               |
|           t       t           |
L----w--------- - --------w-----|
