-----------I---===---I---------- 
|                               |
|          |         |          |
|          |         |          |
|          |         |          |
|          |         |          |
|          |         |          |
|          |         |          |
L---===----|         L----===---|
|                               |
|                               |
|                               |
|                               |
L---------------  --------------|
